Parlez lentement, s'il vous plaît=Please speak slowly
Combien coûte-t-il=How much does it cost
Je cherche=I'm looking for
Comment tu t'appelles=What's your name
Tu es d'où=Where are you from
Ne t'en fais pas=Don't worry
J'ai hâte de te revoir=I can't wait to see you
Je suis énervé=I'm upset
Je suis préoccupé=I'm worried
On verra=We will see
J’irai=I will go
Je partirai=I will leave
Fais voir=Show me
J’aime le café=I love coffee
Qu’est-ce que ça veut dire=What does that mean
Quel est votre artiste préféré=Who's your favorite artist
à mon avis=In my opinion
Bien que je puisse comprendre que=Although I understand that
Cela va sans dire=It goes without saying
Je crois que=I think that
As-tu besoin de billets=Do you need tickets
Attendez-nous là=Wait for us there
C’est pour ce soir=It is for tonight
C’est très gentil=It is very nice
Depuis quand=Since when
Il est parti hier=He left yesterday
Il est prêt=He is ready
Il va dormir=He is going to sleep
Il veut y aller=He wants to go there
J’attends mes amis=I'm waiting for my friends
Je pars ce soir=I’m leaving tonight
Je peux aller là=I can go there
Je peux la voir=Can I see it
Je serai à=I will be at
Je suis arrivé=I have arrived
Je suis malade=I am sick
Je suis perdu=I'm lost
Je suis près de=I am close to
Je te tiens au courant=I'll let you know
Je vais bien, merci=I'm fine, thank you
Ne t’inquiète pas=Don't worry
Où on se retrouve=Where do we meet
Où pouvons-nous manger=Where can we eat
Où veux-tu dîner=Where do you want to have dinner
Où vis-tu=Where do you live
Peux-tu m’aider=Can you help me
Qu’est-ce qui se passe=What's happening
Qu’est-ce que vous recommandez=What do you recommend
Que veux-tu=What do you want
Quel âge as-tu=How old are you
Viens avec moi=Come with me
Ça ne fait rien=It doesn't matter
Quand=When
Qui=Who
Comment=How
Puis-je=May I
C'est un peu comme=It's a bit like
